TLN	Development
DTF	Development
Days_to_budding	Development
LIR	Development
Stem_diameter_at_flowering	Architecture
Plant_height_at_flowering	Architecture
Internode_length	Architecture
Stem_diameter_final_before_1st_node	Architecture
Stem_diameter_final_after_5th_node	Architecture
Distance_of_first_branching_from_ground	Architecture
Primary_branches	Architecture
Leaf_total_N	CN_content
Leaf_total_C	CN_content
Leaf_C_N_ratio	CN_content
Disk_diameter	Inflorescence
Ligule_length	Inflorescence
Ligule_width	Inflorescence
Inflorescence_diameter	Inflorescence
Ligule_LW_ratio	Inflorescence
Flower_FHDD_ratio	Inflorescence
Ligules_number	Inflorescence
Phyllaries_diameter	Inflorescence
Phyllaries_length	Inflorescence
Phyllaries_width	Inflorescence
Phyllaries_LW_ratio	Inflorescence
Flowerhead_to_phyllaries_diameter_ratio	Inflorescence
Disk_to_phyllaries_diameter_ratio	Inflorescence
Peduncle_length_of_first_flower	Inflorescence
Guides_3_ligules	Pigmentation
Guides_individual_ligule	Pigmentation
Guides_3_ligules_mod	Pigmentation
Guides_individual_ligules_mod	Pigmentation
Dark_ligule	Pigmentation
Stem_colour	Pigmentation
Petiole_main_veins_colour	Pigmentation
Darker_axillae	Pigmentation
Leaf_perimeter	Leaf
Leaf_area	Leaf
Leaf_width_mid-height	Leaf
Leaf_maximum_width	Leaf
Leaf_height_mid-width	Leaf
Leaf_maximum_height	Leaf
Leaf_curved_height	Leaf
SLA	Leaf
Trichomes_length	Leaf
Trichomes_density_leaf_edge_flat_area	Leaf
Trichomes_density_leaf_edge_secondary_veins	Leaf
Trichomes_density_leaf_center_flat_area	Leaf
Trichomes_density_leaf_center_secondary_veins	Leaf
Trichomes_density_edge_average	Leaf
Trichomes_density_center_average	Leaf
Trichomes_density_nonvein_average	Leaf
Trichomes_density_vein_average	Leaf
Leaf_curvedHeight_maxWidth	Leaf
Leaf_shape_index_external_I	Leaf
Leaf_shape_index_external_II	Leaf
Leaf_curved_shape_index	Leaf
Leaf_ellipsoid	Leaf
Leaf_circular	Leaf
Leaf_rectangular	Leaf
Leaf_obovoid	Leaf
Leaf_width_widest_pos	Leaf
Leaf_eccentricity	Leaf
Leaf_proximal_eccentricity	Leaf
Leaf_distal_eccentricity	Leaf
Leaf_shape_index_internal	Leaf
Leaf_eccentricity_area_index	Leaf
Total_RGB	Leaf
RGB_proportion_green	Leaf
RGB_proportion_red	Leaf
RGB_proportion_blue	Leaf
Seed_perimeter	Seed
Seed_area	Seed
Seed_width_mid_height	Seed
Seed_maximum_width	Seed
Seed_height_mid_width	Seed
Seed_maximum_height	Seed
Seed_curved_height	Seed
Seed_HW_ratio	Seed
Seed_shape_index_external_I	Seed
Seed_shape_index_external_II	Seed
Seed_curved_shape_index	Seed
Seed_ellipsoid	Seed
Seed_circular	Seed
Seed_rectangular	Seed
Seed_ovoid	Seed
Seed_width_widest_pos	Seed
Seed_eccentricity	Seed
Seed_proximal_eccentricity	Seed
Seed_distal_eccentricity	Seed
Seed_shape_index_internal	Seed
Seed_eccentricity_area_index	Seed
